NO ./texture/greystone.xpm
SO ./texture/purplestone.xpm
WE ./texture/redbrick.xpm
EA ./texture/wood.xpm

F 220,100,0
C 225,30,0

        1111111111111111111111111
        0000000000000000000000000
        0000000000000000000000000
        00000000000000000N0000000
000000000000000000000000000000000
000000000000000000000000000000000
00000000000000000000000000000
00000000000000000000000000000
00000000000000000000000000000
00000000000000000000000000000
000000000000000000000000000000
000000000000000 00000000000000
00000000 0000000  0000000000000
00000000 0000000 000000000 0000