NO ./texture/leaf.xpm
SO ./texture/rocks.xpm
WE ./texture/planks.xpm
EA ./texture/bluebrick.xpm

F 0,0,0
C 225,30,0

111111111111111111111111111111111
100000000000000000000000000000001
100000000000001111110000000000001
100000000000001000010000000000001
100000000000001000010000000000001
100000000000001111110000000000001
100000000000000000000000000000001
100000111110000000000000000000001
1000001000100000000S0000000000001
100000111110000000000000000000001
100000000000000000000000000111111
100000000000000000000000000111111
100000000000000000000000000000001
100000000000001111110000000000001
100000000000001000010000000000001
100000000000001000010000000000001
100000000000001111110000000000001
111111111111111111111111111111111