NO ./texture/north 
SO ./texture/south
WE ./texture/west 
EA ./texture/east  

F 220,100,0
C 225,30,0

   1
   1
   1     111111111111111111111111111
  111     1000000000110000000000001
  101    1001000001110000000000001
  101   100100000000000000N000001
111011111011000001110000000000001
100000000011000001110111111111111
11110111111111011100000010001
11110111111111011101010010001
11000000110101011100000010001
10000000000000001100000010001
100000000000000111101010010001
110000011010111  11101111000111
11110111 1110101  1101111010001
11111111 1111111 111111111 1111