NO ./texture/north 
SO ./texture/south
WE ./texture/west 
EA ./texture/east  

F 220,100,0
C 225,30,0

        1111111111111111111111111
        1000000000110000000000001
        1011000001110000000000001
        10010000000000000N0000001
111111111011000001110000000000001
100000000011000001110001110011111
11110111111111011100000010001
11110111111111011101010010001
11000000110101011100000010001
10000000000000001100000010001
100000000000000111101010010001
110000011010111  11101111000111
11110111 1110101  1101111010001
11111111 1111111 111111111 1111