NO ./texture/north 
SO ./texture/south
WE ./texture/west 
EA ./texture/east  

F 255,255,0
C 0,255,255

        1111111111111111111111111
        1000000000110000000000001
        1011000001110000000000001
        10010000011100000N0000001
111111111011000001110000000000001
1000000000110000011110011110011111
111101111111110111000000100011
11110111111111011101010010001
11000000110101011100000010001
10000000000000001100000010001
100000000000000111101010010001
110000011010111111101111000111
1111011111110101  1101111010001
11111111 1111111 11111111111111