NO ./texture/north 
SO ./texture/south
WE ./texture/west 
EA ./texture/east  

F 42,42,0
C 0,128,128

        1111111111111111111111111
        1000000000110000000000001
        1011000001110000000000001
        1001000001110000000S00001
111111111011000001110000000000001
1000000000110000011110111110111111
111101111111110111000000100011
11110111111111011101010010001
11000000110101011100000010001
100000000000000011000000100011
100000000000000111101010010001
1100000110101111111011110001111
1111011111110101  1101111010001
11111111 1111111 11111111111111